d000mmm0000mm0m
mmm0m000mm0mm0m
m0m0mmm0mm0m000
m0000000mm0m0m0
mmmmmmmmmm0m0m0
000mm000000m0m0
0m0m00mmmmmm0m0
m00mm0mm00000m0
m0mmm0m00mmmmm0
m00000m0mm00000
mmm0mmm0mm0m00m
mmm0m000m00mm0m
0000m0mmmm0mm0m
0mm0000mmm000mm
mmmmmmmmmmmm00a

